a.	Gads, gada, gadā
a.k.	Abonenta kastīte
A.L.M.	Brīvo mākslu maģistrs
abb.	Abbassamento
abrev.	Abreviatūra
abs.	Absolūts
abstr.	Abstrakts
ac.	Akadēmija, augstskola
acc.	Akuzatīvs
accomp.	Akompanements, pavadījums
adj.	Adjektīvs, īpašības vārds
adm.	Administratīvs
admir.	Admirālis
adv.	Adverbs, apstākļa vārds	Advokāts
aeron.	Aeronautika, aeronavigācija
afg.	Afgāņu
afr.	Afrikāņu
A.g.	Akciju sabiedrība
aglom.	Aglomerācija	aglomerāts
agr.	Agrākais	Agronomija	agronomisks	agronoms	agrotehnika
aģit.	Aģitācija	aģitators
ai.	Citiem vārdiem
ak.	Akuzatīvs
akad.	Akadēmija	akadēmisks	akadēmiķis
akuz.	Akuzatīvs
Ala.	Alabama
alb.	Albāņu
alf.	Alfabētisks
allarg.	Allargando
a.m.	Ante meridiem
amb.	Ambulance	ambulatorisks
amer.	Amerikānisms	amerikāņu
analf.	Analfabētisms	analfabēts
anat.	Anatomija	anatomisks
anot.	Anotācija	anotējis	anotēts
ans.	Ansamblis
ant.	Antīks
antirel.	Antireliģisks
antr.	Antropoloģija
antrop.	Antropoloģija
apb.	Apbalvots
apd.	Apdare
apdroš.	Apdrošināšana
apdz.	Apdzīvots
apg.	Apgabals	Apgāds
apgr.	Apgrozījums	apgrozība	Apgrieziens
apgr.	Apgrozījums	apgrozība	Apgrieziens
apģ.	Apģērbi
apl.	Aploksne
apm.	Apmēram
apr.	Apriņķis	Apraksts	Aprīlis
apsk.	Apskats
apst.	Apstākļa vārds
apstipr.	Apstiprinājis	apstiprinājums	apstiprināts
apstr.	Apstrāde
apstrād.	Apstrādājis	apstrādājums	apstrādāts
apv.	Apvidus	Apvidvārds, dialektāla nozīme, nozīmes nianse
aq.	Ūdens
aram.	Aramiešu valoda
aranž.	Aranžējis	aranžējums
arc.	Lociņš
argent.	Argentīniešu
arh.	Arhitektūra	arhitekts
arheol.	Arheoloģija
arhip.	Arhipelāgs
arhit.	Arhitektūra
ārkārt.	Ārkārtējs
arm.	Armēņu	armēņu valoda
arp.	Akorda skaņu izpildījums nevis vienlaicīgi, bet citu aiz citas kāpjošā vai krītošā secībā
arpegg.	Akorda skaņu izpildījums nevis vienlaicīgi, bet citu aiz citas kāpjošā vai krītošā secībā
ārstn.	Ārstniecība	ārstniecisks
ārz.	Ārzemju
asīr.	Asīriešu
asist.	Asistents
asoc.	Asociācija	asociētais, asociētā
ass.	Ļoti	pastiprina apzīmējumu, kam tas pievienots
astr.	Astronomija	astronomisks
astrol.	Astroloģija
atb.	Atbildīgais	atbildīgā
atdzej.	Atdzejojis
atgriez.	Atgriezeniskais
atkl.	Atklājums	atklāts	atklājis
atm.	Atmosfēra	normālā
atr.	Atradne
atref.	Atreferējums
ats.	Atsevišķs
att.	Attēls	Attacca
aud.	Auditorija
auditor.	Tāds, kas attiecas uz auditoriem vai auditu
aug.	Augusts
augst.	Augstākais	augstums	augstiene
augstsk.	Augstskola
austr.	Austriešu
austrāl.	Austrāliešu	austrāliešu valoda
aut.	Autors, autore	Autotransports
autogr.	Autogrāfs
autom.	Automātika
auton.	Autonoms
autoriz.	Autorizēts
av.	Aviācija
ax.	Tauki, it sevišķi cūku tauki
azerb.	Azerbaidžāņu
b.	Beigas	Beigās	Balle
babil.	Babiloniešu
bakt.	Bakterioloģija	Baktērija
bals.	Balsīgs
baltkr.	Baltkrievu
barb.	Barbarisms
bas.	Baseins
bašk.	Baškīru
bat.	Bataljons
bazn.	Baznīca
Bc.	Bakalaurs
bezmugurk.	Bezmugurkaulnieks
bezp.	Bezpersonas darbības vārds
bezpers.	Bezpersonas darbības vārds
bezpriev.	Bezprievārda
Bfr.	Beļģijas franks
bibl.	Biblisms
bij.	Bijušais	bijusī
biļ.	Biļetens
bioķīm.	Bioķīmija
biol.	Bioloģija	bioloģisks
bišk.	Biškopība
biškop.	Biškopība
bizant.	Bizantiešu
blīv.	Blīvums
bot.	Botānika	botānisks
braz.	Brazīliešu
brigad.	Brigadieris
bril.	Brillante
broš.	Brošēts	brošūra
bt.	Baronets
bto.	Bruto
bulg.	Bulgāru	bulgāru valoda
bulv.	Bulvāris
burj.	Burjatu
burt.	Burtiski
burtn.	Burtnīca
burž.	Buržuāzija	buržuāzisks
būvn.	Būvniecība
c.	Cena	Centrs	Ciems
cad.	Kadence
cal.	Noklusinot, reizē arī palēninot	Kalorija
cand.	Kandidāts
caursk.	Caurskatīja	caurskatīts
cēl.	Cēliens
celtn.	Celtniecība
centr.	Centrālais
cet.	Ceturksnis
ceturtd.	Ceturtdiena
cien.	Cienījamais	cienījamā
cilv.	Cilvēks
clar.	Klarnete
cmm.	Kubikmilimetrs
Co.	Kompānija
comp.	Sabiedrība
conc.	Sagriezts	Koncentrēts
conj.	Konjunktīvs
consp.	Uz receptēm saīsināts "consperge", apkaisi
cont.	Uz receptēm saīsināts "contusus", sagrūzts
cor.	Mežrags
Corp.	Angļu "Corporation", akciju sabiedrība
cr.	Tekoša
cresc.	Crescendo
čemb.	Čembalo
čemp.	Čempions
d.	Deci	Daļa	Diena	Diennakts	Dēls
D.C.	Kolumbijas apgabals
dagest.	Dagestāņu
dal.	Dalīts, dalījums
darb.	Darbinieks	Darbības vārds
dārzk.	Dārzkopība	dārzkopis, -e
dat.	Datīvs
dator.	Datorzinātne
daudzg.	Daudzgadīgs
daž.	Dažādās nozīmēs, dažādi
dec.	Decembris
decr.	Decrescendo
decresc.	Decrescendo
dekor.	Dekoratīvs
del.	Korektūrā	Vara gravējumu parakstos
dem.	Deminutīvs	Demokrātija	demokrātisks
demokr.	Demokrātija	demokrātisks
dep.	Deputāts	Departaments
depart.	Departaments
dermat.	Dermatoloģija	dermatoloģisks
diagr.	Diagramma
diam.	Diametrs
dib.	Dibināts	dibināta	dibinājis	dibinājusi
dif.	Diferenciāls
dim.	Diminuendo
dimin.	Diminuendo
din.	Dinārs
dipl.	Diplomātija	diplomātisks
dir.	Diriģents
disert.	Disertācija
div.	Divīzija	Diversa	divide	divus	diva	divisi
divd.	Divdabis
divsk.	Divskaitlis
doc.	Docents
dok.	Dokuments
dokt.	Zinātņu doktors
dol.	Dolārs	Dolce
Dr.	Doktors
dram.	Dramatisks	dramaturgs
dsk.	Daudzskaitlis
dubl.	Dublēts
dz.	Dzimis	dzimusi	Dzimta	Dzimte	Dzīvoklis	Dzīvsudrabs
dzc.	Dzelzceļš
dzelzc.	Dzelzceļš
dziļ.	Dziļums	dziļākais
dzims.	Dzimšanas
dzīv.	Dzīvojamais	dzīvojis
dzīvn.	Dzīvnieks
e.o.	Saskaņā ar amatu, saskaņā ar pienākumiem
ebr.	Ebreju	ebreju valoda
ed.	Izdevums, izdevis
ēd.k.	Ēdamkarote
ēģipt.	Ēģiptiešu valoda
ei.	Tā paša
eif.	Eifēmisms
eifēm.	Eifēmisms
eirorem.	Eiroremonts
ek.	Ekonomika
ekol.	Ekoloģija, vides aizsardzība
ekon.	Ekonomija	ekonomisks,-a
Ekr.	Igaunijas krona
eks.	Eksemplārs	Eksāmens
eksp.	Eksports	eksportēts
ekspl.	Ekspluatācija
ekv.	Ekvators	ekvatoriāls
el.	Elektrotehnika	Elektronika	Elektronisks	Elements
elektr.	Elektrisks	elektrificēts
elektron.	Elektronika
elem.	Elements
enerģ.	Enerģētika
ent.	Entomoloģija
ērt.	Ar ērtībām
Esc.	Portugāles eskudo
eskim.	Eskimosu valoda
esp.	Esperanto
espr.	Espressione
esq.	Augsti godātais, uz vētuļu adresēm, aiz vārda
etc.	Un tā tālāk
etiop.	Etiopiešu valoda
etn.	Etnisks	Etnogrāfija
etnogr.	Etnogrāfija	etnogrāfisks
Ev.	Evanģēlijs
ev.	Evaņģēlisks
exc.	Pagatavojis	sākot no 16-18 gs. uz vara gravējumiem u. c. pielikums apgādātāja vārdam
excl.	Ekskluzīvi
ez.	Ezers
f.	Fonds
fag.	Fagots
fak.	Fakultāte
farm.	Farmācija	farmakoloģija
febr.	Februāris
fec.	Fecit
fed.	Federācija	federatīvs	federāls
feniķ.	Feniķiešu valoda
feod.	Feodālisms	feodāls
fest.	Festivāls
filol.	Filoloģijas
filos.	Filozofija	filozofisks	filozofijas
filoz.	Filozofija	filozofisks	filozofijas
fin.	Finanses	finanšu
fiz.	Fizika	fizisks	fiziķis
fiziol.	Fizioloģija
fizk.	Fiziskā kultūra un sports
fo.	Folio, formāta apzīmējums grāmatu spiestuvēs
fol.	Receptēs lapas	Formāts
folkl.	Folklorā sastopams
fot.	Fototehnika
fotogr.	Fotogrāfija, fotogrāfs
fps.	Pēdas sekundē
Fr.	Franks
fr.	Franču	franču valoda
fragm.	Fragments
frekv.	Frekventatīvs
fudg.	Nodrošināts aizņēmums
g.	Gads	gadīgs
gab.	Gabals
gal.	Galotne
galv.	Galvenais	galvenā
gar.	Garākais	garums
gest.	Miris
gez.	Zīmējis, parakstījis
gk.	Galvenokārt
gl.	Glāze
glac.	Glaciāls
glezn.	Glezniecība
gliss.	Glisando
god.	Godājamais	godājamā
gr.	Kalnu grēda	Grieķu	grieķu valoda	Sengrieķu valoda	Grupa
gram.	Gramatika
grāmatv.	Grāmatvedība
grav.	Gravējums	gravīra
groz.	Grozījums	grozīts
gruz.	Gruzīnu	gruzīnu valoda
gs.	Gadsimts
gt.	Gadu tūkstotis
gtt.	Pilieni
gub.	Guberņa
gv.	Gvarde
ģ.	Ģints
ģen.	Ģenerālis	Ģenitīvs, arī ģenitīvenis
ģenēt.	Ģenētika
ģenit.	Ģenitīvenis
ģeod.	Ģeodēzija	ģeodēzisks
ģeofiz.	Ģeofizika
ģeogr.	Ģeogrāfija
ģeol.	Ģeoloģija	ģeoloģisks
ģeom.	Ģeometrija	ģeometrisks
ģeomorfol.	Ģeomorfoloģija
ģerm.	Ģermāņu	ģermāņu valodas
ģīm.	Ģīmetne
ģimn.	Ģimnāzija
h.	Gods	Tas
hb.	Receptēs
hektogr.	Hektografēts	hektogrāfs
herald.	Heraldika, heraldisks
hidr.	Hidroloģija, hidrauliskā tehnika
hidroģeol.	Hidroģeoloģija
hidrol.	Hidroloģija
hidrot.	Hidrotehnika
hidrotehn.	Hidrotehnika
hig.	Higiēna	higiēnisks
hip.	Hipotēze	hipotētisks
hist.	Historiogrāfija	attiecas uz vēstures zinātni
hol.	Holandiešu	holandiešu valoda
hon.	Cienījamais, cēlais
horv.	Horvātu
hrest.	Hrestomātija
hron.	Hronisks
hum.	Humoristiski	humoristisks	humoristiska ekspresīvā nokrāsa
humor.	Humoristiski
I.N.R.I.	Jēzus no Nācaretes, jūdu ķēniņš
ib.	Turpat, tai pašā rakstā
ibd.	Turpat, tai pašā rakstā
ibīd.	Turpat, tai pašā vietā
id.	Tas pats	apzīmējums, ko lieto, lai nebūtu jāatkārto nupat citētas grāmatas vai raksta autors
iec.	Iecirknis
iedz.	Iedzīvotāji
iel.	Ieleja	Ielikums	Ielīme
iepl.	Ieplaka
ier.	Ieraksts	ierakstīts
ies.	Iesiets
iesk.	Ieskaite	Ieskaitot	ieskaitīts
iesp.	Iespiedums	iespiests	iespiešana
iest.	Iestāde
iestud.	Iestudējums	iestudējis
iev.	Ievads
ievadr.	Ievadraksts
ig.	Igauņu	igauņu valoda
iht.	Ihtioloģija
il.	Ilustrācija	ilustrējis	ilustrēts
imp.	Imports	importēts
imper.	Imperiālisms	imperiālistisks
imperf.	Imperfektīva forma	norāde, ka darbības vārds apzīmē darbības norisi, nepabeigtu darbību
impf.	Imperfekts, vienkāršā pagātne
Inc.	Amerikāņu apzīmējums akciju sabiedrībai
incl.	Ieskitot
indon.	Indonēziešu
inf.	Informātika	Infekcija	infekciozs
inform.	Informācija	informatīvs	Informātika
insc.	Inscenējis
inscen.	Inscenējums	inscenēts
insp.	Inspektors	inspekcija
inst.	Institūts
instr.	Instrukcija	Instrumentācija	instrumentāls	instrumentējis	Instrumentālis
instrum.	Instruments
int.	Integrāls	Interjekcija, izsauksmes vārds
interj.	Interjekcija	izsauksmes vārds
intr.	Intransitīvs, nepārejošs
intrans.	Intransitīvs	nepārejošs	norāde, ka darbības vārds nosauc darbību, kas saistīta ar subjekta fizisku vai garīgu stāvokli vai atrašanos telpā un nav vērsta uz objektu akuzatīvā
inv.	Inventārs	Vara grebumos, kokgriezumos u. c. orīģināla autora vārds
inž.	Inženieris
īp.	Īpašības vārds	Īpatnējs, īpatnējais
īpašv.	Īpašvārds
iron.	Ironiski	ironiskā nozīmē	ironiska ekspresīvā nokrāsa
isl.	Islandiešu	islandiešu valoda
ist.	Istaba	telpu skaits
īst.	Īstenais	īstais
it.	Itāļu	itāliešu	itāliešu valoda	Tāpat, tālāk
izd.	Izdevējs	izdevis	izdevums	izdots
izdevn.	Izdevniecība
izejv.	Izejviela	izejvielas
izkl.	Izklāsts
izl.	Izloksne	Izlaidums
izm.	Izmērs
izol.	Izolēts
izp.	Izpildītājs	izpildītāja
izpl.	Izplatība	izplatīts
izr.	Izrakteņi, derīgie
izsauk.	Izsauksmes vārds
izstr.	Izstrādājis	izstrādājums, izstrādne
izstrād.	Izstrādājis	izstrādājums, izstrādne
j.	Jūra
janv.	Janvāris
jap.	Japāņu	japāņu valoda
jaun.	Jaunākais	jaunākā
jaungr.	Jaungrieķu valoda
jaunlat.	Jaunlatīņu valoda
jaut.	Jautājamais
jav.	Javiešu valoda
jid.	Jidišs
jlat.	Jaunlatīņu literatūra
Jr.	Jaunākais
jūl.	Jūlijs
jūn.	Jūnijs
jun.	Juniors	juniore	jaunākais	jaunākā
jur.	Juridisks	jurists	jurisprudence	juridiski
jūr.	Jūrniecība
jūrn.	Jūrniecība
k.	Kalns	Kolhozs
kab.	Kabinets
kal.	Kalorija
kalm.	Kalmiku
kaln.	Kalniene
kalnr.	Kalnrūpniecība
kan.	Kanāls
kanād.	Kanādiešu
kanal.	Kanalizācija
kand.	Kandidāts
kap.	Kapeika	Kapitāls	kapitālisms	kapitālistisks
kapt.	Kapteinis
kart.	Kartogrāfija
kārt.	Kārtojums,
kartogr.	Kartogramma
kat.	Katedra	Kategorija
katal.	Katalogs	kataloģizēt
kateg.	Kategorija
kaz.	Kazahu
ker.	Keramika
kib.	Kibernētika
kibern.	Kibernētika	kibernētisks
kinem.	Kinematogrāfija	kinematogrāfisks
kirg.	Kirgīzu	kirgīzu valoda
kl.	Klase	Klasiskais, -ā
klav.	Klavieres
klaves.	Klavesīns
klim.	Klimats	klimatisks
klīn.	Klīnisks
koef.	Koeficients
kokapstr.	Kokapstrāde
kokv.	Kokvilna
kol.	Kolektīvs	Kolonija	koloniāls
kom.	Komisija	Komiteja
komb.	Kombināts	Kombinēts
koment.	Komentārs	komentējis	komentētājs
komerc.	Komerciāls	komercija
komj.	Komjaunatne	komjaunietis
komp.	Komparatīvs, pārākā pakāpe	Komponējis	komponēts	kompozīcija	komponists
komun.	Komunāls
konc.	Koncentrācija	koncentrāts	koncentrēts
konf.	Konference
kongr.	Kongress
konj.	Konjunkcija, saiklis
konst.	Konstatēts	konstatējis	Konstitūcija	konstitucionāls
konstr.	Konstruktors	konstrukcija	konstruējis
kont.	Kontinentāls	kontinents
koop.	Kooperatīvs
kopdz.	Kopdzimtes vārds
kopsk.	Kopskaits
kor.	Korejiešu valoda	Korespondents
korej.	Korejieši, korejiešu valoda
kosm.	Kosmētiskais	Kosmonautika
kosmon.	Kosmonauts	kosmonautika
kp.	Kredītpunkts
kr.	Krāces	Kreisais	Krievu	krievu valoda
krāj.	Krājums
krās.	Krāsains, krāsaina
kub.	Saīsinājumos
kul.	Kulinārija
kur.	Kūrorts
kv.	Kvadrāt
kval.	Kvalitāte
kvant.	Kvantitāte
ķerm.	Ķermenis
ķieģ.	Ķieģeļu
ķīlr.	Ķīļraksts
ķīļr.	Ķīļraksts
ķīm.	Ķīmija	ķīmiķis	ķīmisks
ķīn.	Ķīniešu	ķīniešu valoda
ķir.	Ķirurģija	ķirurģisks
l.	Lieta
L.	Lielais, lielā
lab.	Labojis	labojums	labots	Laboratorija	laborants
labd.	Labdabīgs
lag.	Lagūna
laid.	Laidiens
laikm.	Laikmets
laikr.	Laikraksts
lat.	Latīņu	latīņu valoda
latg.	Latgaliešu	latgaliski
latv.	Latviešu
lauk.	Laukums
lauks.	Lauksaimniecība	lauksaimniecisks
laur.	Laureāts
lb.	Labais	Mārciņa	Lamberts
Ld.	Norāde uz ierobežotu atbildību pie firmas nosaukuma
leg.	Legato
legg.	Leggero
leitn.	Leitnants
lejasv.	Lejasvācu valoda
lekc.	Lekcija
lekt.	Lektors
lib.	Liber
līb.	Lībiešu
lic.	Licejs	Licence	licencēts	licencēta	Licenciāts
līdz.	Līdzeklis	Līdzenums
līdzsk.	Līdzskanis
līdzstr.	Līdzstrādnieks
lieg.	Liegums
liel.	Lielākais	lielums
liet.	Lietuviešu
lietuv.	Lietuviešu valoda
lietv.	Lietvārds
līg.	Līgums
līm.	Līmenis
līn.	Līnija	Līnija
lingv.	Lingvistisks, valodniecisks
liq.	Receptēs šķidrums
lit.	Literatūra	literārs
liter.	Literatūrzinātne
literat.	Literatūrzinātne
loc.	Loceklis	locekle
loģ.	Loģika
lok.	Lokatīvs
lopk.	Lopkopība
lp.	Lapa
lpp.	Lappuse
lusing.	Lusingando
Ļ.	Ļeņingrada
ļaund.	Ļaundabīgs
M.	Maskava	Mazais	Metro
m.	Māja	Meita	Miris	miršanas	Mūsu	Masa	Manuāli
M.A.	Maģistrs
M.S.	Maģistrs	MSc
M.Sc.	Maģistrs	MSc
M.Sci.	Maģistrs	MSc
M.Si.	Maģistrs	MSc
māc.	Mācība	mācību
magn.	Magnētisks
maj.	Majors	Majeur, mažors
maks.	Maksimums	maksimāls	maksimālais
māksl.	Māksliniecisks	mākslinieks
malaj.	Malajiešu valoda
manc.	Mancando
marc.	Marcando
mārc.	Mārciņa
marok.	Marokāņu
mas.	Masīvs
Mas.	Masora
maš.	Mašīna
mat.	Matemātika	matemātisks
mater.	Materiāls
maž.	Mažors
mēb.	Mēbeļu
med.	Medicīna	medicīnisks
medn.	Medniecība
meh.	Mehānika	mehānisks	mehāniķis
meks.	Meksikāņu
mel.	Melodija
melior.	Meliorācija
mēn.	Mēnesis	mēnesī, mēnešu
mer.	Meridiāns	meridionāls
met.	Meteoroloģija
metal.	Metalurģija
meteor.	Meteoroloģija
meteorol.	Meteoroloģija
metod.	Metodisks
metr.	Metroloģija
mez.	Mezzo
mež.	Mežsaimniecība, mežzinātne, mežķīmija
mežr.	Mežrūpniecība
mežs.	Mežsaimniecība
mf.	Ne pārāk skaļi
Mg.	Maģistrs
mil.	Militārās zinātnes	militārā terminoloģija
mīlin.	Mīlinājuma nokrāsa
milit.	Militārs
milj.	Miljons
min.	Minors	Mineraloģija	Ministrija	Minūte
minim.	Minimums	minimāls
mit.	Mitoloģija
mljrd.	Miljards
mob.	Mobilais telefons
mod.	Modalitāte	modālais darbības vārds	Moderato
mol.	Molekula	molekulārs
mold.	Moldāvu
mong.	Mongoļu	mongoļu valoda
mor.	Morendo
mugurk.	Mugurkaulnieks
mūsd.	Mūsdienu
mūz.	Mūzika
muz.	Muzejs	Muzikāls
n.	Savienojumā "n. reģ. t."
N.	Nopelni, goda nosaukumos	Savienojumā "N. B."	Savienojumā "N. N."
nac.	Nacionāls
nāk.	Nākamais	Nākotne
neakt.	Neaktuāls
ned.	Nedēļa
neiesk.	Neieskaitot	neieskaitīts
nelok.	Nelokāms
nenot.	Nenoteiktā
nenum.	Nenumurēts
ner.	Nerūsējošs
nevēl.	Nevēlams
nez.	Nezināms
nicin.	Nicinoši
niev.	Nievājoši
nl.	Nīderlandiešu	nīderlandiešu valodā
nob.	Nobeigums
nod.	Nodalījums	nodaļa
nodarb.	Nodarbība	nodarbošanās	nodarbināts
nodroš.	Nodrošināšana
nokr.	Nokrišņi
Nol.	Noliegums, noliegts
noliedz.	Noliedzamais
nom.	Nominatīvs
norād.	Norādāmais	Norādījums
norv.	Norvēģu	norvēģu valoda
nos.	Nosaukums	nosaukts
not.	Noteiktā	Noteikumi
noteic.	Noteicamais
nov.	Novads	Novembris
novec.	Novecojis, novecojošs
novilk.	Novilkums
noz.	Nozīme	nozīmē
nozīm.	Nozīmīgākais
Nr.	Numurs
nr.	Numurs
num.	Skaitļa vārds, numerālis
O.K.	Viss kārtībā	amerikāņu izteiciens: pareizi	jā	protams	ar mieru
ob.	Oboja	Nomiris
obj.	Objektīvs	objekts
ofic.	Oficiāls
ogļh.	Ogļhidrāts
ok.	Okeāns
okaz.
okean.	Okeanoloģija
okt.	Oktobris
okup.	Okupācija	okupants	okupēts
ol.	Eļļa
olbv.	Olbaltumviela
op.	Opuss
ord.	Ordinario
org.	Organizācija	Organo, ērģeles
oriģ.	Oriģināls
orķ.	Orķestris
ornit.	Ornitoloģija
oset.	Osetīnu	osetīnu valoda
otrd.	Otrdiena
p.	Pants	Pilsēta	Punkts	Puse	pusē
P.	P. S
p.m.ē.	Pirms mūsu ēras
pad.	Padome	padomju
pag.	Pagasts	Pagātne	Pagājušais	pagājusī
pak.	Pakāpe
paleont.	Paleontoloģija
pamaz.	Pamazinājuma forma
pans.	Pansionāts
papild.	Papildinājis	papildinājums	papildināts
papīrr.	Papīrrūpniecība
paplaš.	Paplašināts
pār.	Pāreja
paral.	Paralēls
parapsih.	Parapsiholoģija
pārb.	Pārbaudījis	pārbaudījusi	pārbaudījums	pārbaude
pārdr.	Pārdrukāts
pārej.	Pārejošs darbības vārds, pārejoši lietots darbības vārds
parf.	Parfimērija
pārgroz.	Pārgrozījums	pārgrozīts
pārlab.	Pārlabojis	pārlabojums	pārlabots
pārlūk.	Pārlūkojis	pārlūkots
pārn.	Pārnestā nozīmē
pārsk.	Pārskatīts
pārstr.	Pārstrāde
pārstrād.	Pārstrādājis	pārstrādājums
pārt.	Pārtika	pārtikas rūpniecība
part.	Partija	Particips, divdabis	Partikula
pārv.	Pārvalde
pas.	Pasaule	pasaulē
paskaidr.	Paskaidrojis	paskaidrojums
pasūt.	Pasūtījums
paširon.	Pašironiski, pašironisks, pašironija
pašnos.	Pašnosaukums
pat.	Patents	patentēts	patentēta
patol.	Patoloģija	patoloģisks
pav.	Pavēles forma
pc.	Pilsētciemats
pēcv.	Pēcvārds
ped.	Pedagoģija	pedagoģisks
pēd.	Pēdējais
pens.	Pensionārs
per.	Periods	periodā	periodisks
perd.	Perdendo
pers.	Persiešu valoda	Persona	personas
persv.	Personvārds
pētīj.	Pētījums
phil.	Filozofija	Filoloģija
philos.	Filozofija
pieder.	Piederības
piektd.	Piektdiena
piel.	Pielikums
piem.	Piemēram
piemin.	Piemineklis
piez.	Piezīme
pil.	Pilieni
pilnv.	Pilnvarotais, -ā
pils.	Pilsēta	Pilsonis, pilsone
pirmd.	Pirmdiena
pizz.	Pizzicato
pl.	Platība	Pulksten	Daudzskaitlis
plat.	Platums
plkst.	Pulksten
p.m.	Pēcpusdienā
poēt.	Poētisms	poētiska stilistiskā nokrāsa
pol.	Politika
poligr.	Poligrāfija
polikl.	Poliklīnika	poliklīnisks
polim.	Polimērija
polinēz.	Polinēziešu valodas
polit.	Politisks	politisks termins
popul.	Populārs
port.	Portugāļu	portugāļu valoda
portug.	Portugāļu
pos.	Posaune
pp.	Turpini, turpini, t. i. un tā tālāk
pr.	Prospekts
pref.	Prefektūra
prēm.	Prēmija
prep.	Prepozīcija, prievārds
pried.	Priedēklis
priekšp.	Priekšpilsēta
priev.	Prievārds
priv.	Privatizēts
proc.	Procents, procenta	Prokonsuls	Prokūra
prod.	Produkcija
prof.	Profesionāls	Profesors, profesore
profes.	Profesionāls
progr.	Programma	Progresīvs
proj.	Projekts	projektēts	projektējis
prolet.	Proletariāts	proletārisks
pron.	Pronomens, vietniekvārds
proporc.	Proporcionāls
prosp.	Prospekts
prot.	Protokols
prov.	Province
provans.	Provansiešu valoda
P.S.	Papildinājums uzrakstītai un parakstītai vēstulei	postskripts
ps.	Pseidonīms	pseid
pseid.	Pseidonīms	ps
psih.	Psiholoģija, psihoanalīze	Psihisks
psihoan.	Psihoanalīze
psihol.	Psiholoģija	psiholoģisks
psk.	Pamatskola
pss.	Pussala
publ.	Publicēts	publikācija	Publisks
pūt.	Pūtēju
pxt.	Gleznoja
r.	Rajons	Riņķis
R.	Rīga
R.S.V.P.	Uzraksts uz ielūguma
rac.	Racionalizācija
rad.	Sakne
raj.	Rajons
rall.	Rallentando
ras.	Rasēšana, rasējums
raž.	Ražošana	ražojums
rbl.	Rublis
rbļ.	Rubļi
reakc.	Reakcionārs
rec.	Receptēs: svaigi pagatavots
red.	Redaktors, redaktore	redakcija	rediģējis, rediģējusi	rediģēts
redkol.	Redakcijas kolēģija
ref.	Referāts	referents
refl.	Refleksīvs	tāds, kas attiecas uz darbības subjektu	atgriezenisks
reģ.	Reģistrēts	Reģions	reģionāls
rel.	Relatīvs	Reliģija	reliģisks
relj.	Reljefs
rem.	Remonts
renes.	Renesanse
rep.	Republika	republikānisks	Atkārtojums
reprod.	Reprodukcija
resp.	Respektīvi
rest.	Restaurēts
retrosp.	Retrospektīvs
Rev.	Reverend
rev.	Revolūcija	revolucionārs
rez.	Rezervāts
rež.	Režija	režisors
rf.	Rinforzando
rfz.	Rinforzando
rinf.	Rinforzando
rit.	Ritenuto
ritard.	Ritardando
riten.	Ritenuto
rokr.	Rokraksts
rom.	Romāns	Romāņu
rum.	Rumāņu	rumāņu valoda
rūpn.	Rūpniecība	rūpnīca	rūpniecisks
s.	Suga	Sala	Sieviešu dzimte
S.L.	Bez izdošanas vietas norādes
sab.	Sabiedrisks
sagat.	Sagatavojis	sagatavotājs
sagroz.	Sagrozīts vārds
saimn.	Saimniecība	saimniecisks
saīs.	Saīsinājums	saīsināts	saīsināti
sāk.	Sākums	sākuma	sākumā
sakārt.	Sakārtojis	sakārtotājs
sakop.	Sakopojis	sakopotājs
sal.	Salīdzinājumā	salīdzini	salīdzināt	salīdzinājums
saloc.	Salocīts
san.	Sanitārais	sanitārs
sanat.	Sanatorija
sanskr.	Sanskrita	sanskrits
sant.	Santīms
sar.	Sarunvalodā lietots	sarunvalodas stilistiskā nokrāsa	Sarakstīts	sarakstījis
sarunv.	Sarunvalodas vārds
sast.	Sastādītājs	sastādījis, sastādījusi
sat.	Satiksme
sav.	Savienība	savienotais
Sc.M.	Maģistrs	MSc
scil.	Proti
scr.	Rakstīja
Sct.	Svētais
sec.	Sekunde	Sekante
seg.	Mūzikā aizrādījums lappuses beigās, ka skaņdarbs vēl nav galā, bet turpinās nākamā lappusē
sēj.	Sējums
sek.	Sekunde
sekr.	Sekretārs
selekc.	Selekcija
sem.	Semītu valodas	Sempre
sen.	Seniors, seniore	vecākais, vecākā
senaugšv.	Senaugšvācu
senebr.	Senebreju valoda
senēģipt.	Senēģiptiešu valoda
senfr.	Senfranču valoda
sengr.	Sengrieķu
senind.	Senindiešu valoda
sennorv.	Sennorvēģu valoda
sensk.	Senskandināvu valoda
sensl.	Senslāvu valoda
senv.	Sens, reti lietots vārds
sept.	Septembris
seq.	Sekojošs
sēr.	Sērija	sērijveida
sert.	Sertifikāts	sertificēts	sertificēta
sestd.	Sestdiena
sf.	Sforzando
sfz.	Sforzando
sh.	Shēma	Šiliņš
siev.	Sieviešu
siltumt.	Siltumtehnika
sim.	Simile
simb.	Simbols
simf.	Simfonisks	simfonija
sin.	Sinistra
sing.	Vienskaitlis
singal.	Singalu valoda
sint.	Sintēze	sintētisks
sist.	Sistēma	sistemātisks
sk.	Skatīt	Skola
skait.	Skaitļa vārds
skand.	Skandināvu	skandināvu valoda
skaņd.	Skaņdarbs
skat.	Skatīt
sl.	Sleja	Slāvu	slāvu valoda	slāvisks	Slengs
slimn.	Slimnīca	slimnieks
sm.	Smaile
smorz.	Smorzando
soc.	Sociālisms	sociālistisks
sociol.	Socioloģija
sol.	Šķīdinājums
sost.	Sostenuto
sp.	Spāņu	spāņu valoda	Sporta	sports
spec.	Specializācija	speciāls	specializēts	spec	speciālists
spied.	Spiedogs
spl.	Vienkāršs
sq.	Skvērs	kvadrāts, kvadrāt
St.	Svēts
st.	Stacija	Stunda	Stāvs	Stūris [ielu]
stacc.	Staccato
stad.	Stadions
stand.	Standarts
starpt.	Starptautisks
stat.	Statistika
string.	Stringendo
strukt.	Struktūra	strukturāls
stud.	Students	studējis, -usi
subj.	Subjekts	subjektīvs
subt.	Subtitri
superl.	Superlatīvs, vispārākā pakāpe
Sv.	Svētais, -ā
svētd.	Svētdiena
syn.	Sinonīms
š.	Šis
šaur.	Šaurums
šķ.	Šķira
šķīd.	Šķīdums
šļūd.	Šļūdonis
šos.	Šoseja
šum.	Šumeru valoda
šveic.	Šveiciešu
t.	Telefona numurs	Tumši	Tas	To	Tauta
T.	Tirāža	Tautas	Tesla
tab.	Tabaka	Tabula
tabl.	Tablete
tac.	Tacet
tag.	Tagadne	Tagadējais	tagadējā
tal.	Tāds pats, līdzīgs
tālr.	Tālrunis
tang.	Tangenss
tat.	Tatāru	tatāru valoda
tdz.	Tautasdziesma
tehn.	Tehnika	tehnisks, tehniķis
tehnol.	Tehnoloģija	tehnologs
tējk.	Tējkarote
tekst.	Tekstilrūpniecība
tel.	Televīzija
telegr.	Telegrāfisks, telegrāfs
telek.	Telekomunikācija
telev.	Televīzija
tēln.	Tēlniecība
ten.	Tenuto
teol.	Teoloģija
ter.	Teritorija
terit.	Teritorija	teritoriāls
tibet.	Tibetiešu valoda
tilp.	Tilpums
timp.	Timpāni
tip.	Tipogrāfija
tirdzn.	Tirdzniecība, tirdzniecisks
tk.	Tūkstotis
tnb.	Tuberkuloze
tp.	Timpāni
tr.	Transitīvs, pārejošs	Treneris	Trompete
trad.	Tradicionāls	tradīcija
trans.	Transitīvs
transp.	Transports
trem.	Tremolo
trešd.	Trešdiena
trik.	Trikotāža
trlj.	Triljons
tromb.	Trombons
tromp.	Trompete
tuksn.	Tuksnesis
tūkst.	Tūkstotis
tulk.	Tulkojums	tulkots	tulkojis	tulkotājs
u.	Un
u.c.	un cits	un cita	un citi
U.K.	Lielbritānija
udm.	Udmurtu
ukr.	Ukraiņu	ukraiņu valoda
ung.	Ungāru	ungāru valoda
univ.	Universitāte
utt.	Un tā tālāk
uvert.	Uvertīra
uzd.	Uzdevums
uzņ.	Uzņēmums
v.	Vīriešu dzimte	Vārds	vārdi	vārdu	Vieta	vietā	Vidus
V.	Viņš, viņa
vad.	Vadībā	vadītājs	vadītāja	vadošais	vadošā
vak.	Vakarā	vakaros
val.	Valoda	valodniecība
var.	Variants	Varietāte
vec.	Vecākais	vecākā
veģ.	Veģetācija	veģetatīvs
vels.	Velsiešu valoda
ven.	Venerisks
vēst.	Vēsture	vēsturisks, attiecas uz agrākajiem laikiem
vet.	Veterinārija
veter.	Veterinārs	Veterinārija
vid.	Vidējs	vidēji	vidējais	vidējā
vidusaugšv.	Vidusaugšvācu valoda
vidushol.	Vidusholandiešu
vidusl.	Viduslaiki, viduslaiku
viduslejasv.	Viduslejasvācu
vien.	Vienība
vienād.	Vienādojums
vieng.	Viengadīgs
vienk.	Vienkāršrunas stilistiskā nokrāsa	vienkāršrunā
viet.	Vietējs
vietn.	Vietnieks	vietniece	Vietniekvārds
vietv.	Vietvārds
virs.	Virsotne
visp.	Vispārējs	vispārīgs
vispārin.	Vispārināmais
vit.	Vitamīns
vjl.	Virs jūras līmeņa
vk.	Vulkāns
voc.	Vokatīvs
vok.	Vokatīvs
vol.	Sējums
vsk.	Vienskaitlis
V.S.O.P.	Augstas kvalitātes maigs konjaks
vulg.	Vulgārisms
X.O.	Konjaka kvalitātes marķējums
z.	Zīmogs
zem.	Zemiene	zemākais, -ā
zemesgr.	Zemesgrāmata
zīm.	Zīmējums	Zīmogs
zin.	Zinātne	zinātnieks	zinātnisks	zinātniska
zjl.	Zem jūras līmeņa
zool.	Zooloģija	zooloģisks
zr.	Zemesrags
Zv.	Zvērināts
zv.	Zvērināts	zvērināta	Zviedru	zviedru valoda
zvejn.	Zvejniecība
zviedr.	Zviedru valoda	zviedriski
žarg.	Žargonisms
žurn.	Žurnāls	žurnālists
